15 15
OOOOOOOOOOOOOXX
OOOOOOOOOOOOOOX
OOOOOOOOOOOOOOO
OOOOOOOOOOOOOOO
OOOXOOOOOOOOOOO
OOOPOOOPOOOPPOO
OOOOOXOOOOOOOOO
OOOOXOOOOOOXOOO
OOOOXPPPOOOOOOO
OOOOOOOOOOOOOOX
OOOOOOOOOOXPOOP
OOOOOOOOOOOOOOO
OOXOOOOOOOOOOOO
OOOOOXOOOOOOOOO
OOOOOOOOOOOOOOV