14 12
OOOOOOOOXOOOPP
OOOXOOOOOOOOOO
OOOOOOOOOXOOOO
OXPOOOOOOPOOOO
XOOOOOOOXPOOOO
OOOOOOOOOOOOPX
OOOOOPXOPOOOOO
OOXOOPPOPPPPOO
OOOOOOOOPOOOOX
OOOOOOOXOOOOPP
OOOOOXOOOXOOOO
OOOOOOOOOOOOOV